test	2	4	5	11	4	2	3	
0	0	2	-1	-1	-1	-1	-1	-1	
1	1	1	-1	-1	4	-1	0	-1	
2	1	3	-1	3	6	-1	1	-1	
3	1	4	-1	-1	-1	2	-1	0	
4	2	1	1	5	7	-1	-1	1	
5	2	2	-1	6	8	4	-1	-1	
6	2	3	2	-1	-1	5	2	-1	
7	3	1	4	8	-1	-1	-1	-1	
8	3	2	5	-1	9	7	-1	-1	
9	4	2	8	10	-1	-1	-1	-1	
10	4	3	-1	-1	-1	9	3	-1	
